//Comment: gibt invalid ap error aber whyyy

















NO             ./assets/north.xpm

C 72,                        1, 255


SO                                      ./assets/south.xpm

EA ./assets/east.xpm

F                    134,                             194,                           50







WE ./assets/west.xpm


1111111
1000001
1000001
1111111
        1111111111111111111111111
        1N00000000110000000000001
        1011000001110000000000001
        1001000000000000000000001
11111111111000001110000000000001
100000000011000001110111111111111
11110111111111011100000010001
11110111111111011101010010001
11000000110101011100000010001
10000000000000001100000010001
10000000000000001101010010001
1100000111010101111101111000111
11110111 1110101 101111010001
11111111 1111111 111111111111





//comment map that causes segfault

        1111111111111111111111111
        1000000000110000000000001
        1011000001110000000000001
       1001000000000000000000001
11111111011000001110000000000001
100000000011000001110111111111111
11110111111111011100000010001
11110111111111011101010010001
11000000110101011100000010001
10000000000000001100000010001
10000000000000001101010010001
1100000111010101111101111000111
11110111 1110101 101111010001
11111111 1111111 11111111111S